14444411111111111a
14444411111111111a
14444411111111111a
11141114444111111a
11141114114111111a
11141114114444411a
11141114111144444a
11144444111144444a
11111111111144444a
11111111111144444