44441111111111111a
44441111111111111a
44441111111111111a
44441114444411111a
44441114111411111a
14111444111411111a
14111411144444111a
14444411144444111a
11111111144444111a
11111111111111111